11111111111111111111
10111100001000001001
1001111111C010000101
11011100000011010111
10000011000E10000101
10101000P1001000C001
1111000C110110000001
100CC100000000001001
11000101110100110101
11111111111111111111